0 0 0 0 0 0 0 0 0 0 0 0 0 
0 16 4 9 1 1 1 15 1 1 1 1 0 
0 0 0 0 0 0 0 0 0 0 0 1 0 
0 6 1 1 2 1 0 0 4 4 2 1 0 
0 1 11 1 0 1 0 0 13 11 0 1 0 
0 0 2 0 0 4 2 10 18 10 0 1 0 
0 4 1 1 0 1 0 0 0 0 0 1 0 
0 1 11 1 0 1 0 0 0 0 0 1 0 
0 0 2 0 0 1 1 0 0 0 0 1 0 
0 6 1 1 0 0 2 0 0 0 0 1 0 
0 6 1 4 0 1 10 4 0 1 1 1 0 
0 1 1 4 0 9 7 1 0 1 1 1 0 
0 0 0 0 0 0 0 0 0 0 0 0 0 
21 9 5 0 0 0 0 0 0 0 0 0 0 
5 4 1 0 9 9 1 1 1 1 10 1 0 
9 9 11 0 0 0 0 0 0 1 0 1 0 
11 11 11 2 1 1 0 0 4 1 0 13 0 
0 3 0 0 0 1 1 1 13 0 0 9 0 
1 1 1 0 0 4 1 1 4 0 0 9 0 
0 0 1 1 9 1 1 1 5 0 0 1 0 
4 0 11 1 0 0 0 3 0 0 0 6 0 
9 0 2 0 0 0 9 1 9 0 0 5 0 
9 0 1 1 0 0 6 9 7 0 0 1 0 
1 1 1 1 0 0 4 13 5 1 0 15 0 
0 0 0 10 0 9 7 0 0 0 0 19 0 
0 16 1 1 0 0 0 0 0 0 0 0 0 
0 0 0 0 0 0 0 0 0 0 0 0 0 
0 1 0 13 11 7 0 11 13 13 13 13 0 
0 1 0 5 0 0 5 0 1 1 11 0 0 
0 1 0 5 0 7 5 0 0 0 3 0 0 
0 1 0 2 0 3 0 0 0 1 1 1 0 
0 1 3 18 1 1 1 1 1 1 0 1 0 
0 1 0 2 0 2 0 0 0 2 0 1 0 
0 1 0 18 0 1 0 0 0 11 0 13 0 
0 1 0 7 18 7 0 0 6 7 0 6 0 
0 1 0 0 2 0 2 0 13 6 0 7 0 
0 15 0 4 7 9 10 0 0 0 0 18 0 
0 19 0 4 7 9 7 0 0 16 1 1 0 
0 0 0 0 0 0 0 0 0 0 0 0 0 
0 0 0 0 1 22 1 0 0 1 9 1 0 
0 0 0 0 1 20 1 0 0 3 0 3 0 
0 0 0 0 0 2 0 0 0 1 0 1 0 
0 0 23 0 18 18 18 0 4 11 0 1 0 
0 0 6 0 9 9 9 0 6 0 0 5 0 
0 0 6 0 11 10 11 0 6 0 0 10 0 
0 0 1 0 0 2 0 0 1 0 0 10 0 
0 0 1 0 11 18 11 0 1 0 0 9 0 
0 0 1 0 14 11 14 0 1 0 0 1 0 
0 0 1 0 0 2 0 0 1 0 0 1 0 
0 0 1 0 4 1 4 0 1 1 0 15 0 
0 0 1 9 1 1 1 9 1 1 0 19 0 
0 0 0 0 0 0 0 0 0 0 0 0 0 
